1111111111111111111111111
100P0000001C00000000001C1
1000100000111111000100101
1C001C000000C000000100001
1111111100100011111111111
10000000001000100001000C1
1000100011100000000100011
1C0010C00100000C1001000E1
1001101001000100100100001
1000001000000100100000001
1111111111111111111111111
