1111111111111111111111111
100P0000001C00000M00001C1
10001000001111110001M0101
1CM01C000000C000000100001
1111111100100011111111111
1000000000100010M001000C1
10M010001110M00000010M011
1C0010C00100000C1M01000E1
1001101001000100100100001
1M00001M000001M010000M001
1111111111111111111111111
