1111111111111111111111111
100P0000001C00000111001C1
1000100000111111000100101
1C001C000000C000000000001
1111111100100011111111111
10000000001000100001000C1
1000100011100000000100011
1C0010C00100000C1001000E1
1101101001000100100100001
1100001000000100100000001
1101001111111100101111101
11010C10C0000000101000101
1101001000100100101010101
100100101010C100101001001
10C100001010000000110C011
1111111111111111111111111
