1111111111
100P0000001
10001000
1C001C000E1
111111
