11111111111
100P0000001
10001000001
100100000E1
11111111111
