1111111111111111111111111111
100P00000000000001000000E001
1000101111100010010001000001
1C001C00000000100000C1011001
1111111111111111111111111111
