111111111111111
100P00010000001
100000010000001
100C000E00C0001
100000010000001
111111111111111
