1111111111111111111111111
100P0C000011C0000000001C1
1000100000111111000100101
1C0010000100C000000100001
1111111100100011111111111
10000000001000100001000C1
1000100011100000000100011
1C0010C000000011100100CE1
1001101001100100100000001
1000001000000100100010001
10010011111111001001111C1
10010C10C0000000101000001
1001001111000001010C01011
1001001000010100101001001
1C110000001C010000110C011
1111111111111111111111111
