11111111111
10000000001
10001000001
1C001C000E1
11111111111
