1111111111111111111111111
100P0000001C00000000001C1
1000100000111111000100101
1C001C000000C000000100001
1111111111000111111111111
10000000001000100001000C1
1000111111000000001000111
1C0010C00100000C1001001E1
1111101001000100100100111
1000001000000100100000001
1001001111111100101111101
10010C10C0000000101000101
1001001000111100101010101
100100100010C100101001001
10C100000010010000110C011
1111111111111111111111111
