11111111111
100P0000001
10001000001
1C001C000E1
11111111111
