111111111111111111111111111111111
100P0000001C00000000001000000E001
10001000001111110P010010001000001
1C001C000000C000000100000C1011001
111111111111111111111111111111111
